11111111111111111111111111
1000000000C00000000000C001
10000000000000000000000001
10000000000000000000000001
1000001v001100000010v01101
1000000000C00000000000C001
100C00000000000C0000000001
100000000P00000C0000000001
1000000v0000000C0000000001
10000000000000000000000001
10C00000000000C00000000001
10000010000000000010000001
10000010000000000010000001
10000010000000000010000001
10000010000000000010000001
10000010000000000010000001
10000010000000000010000001
10000010000000000010000001
10000010000000C00000000001
10000010000000C00000000001
10000010000000C00000000001
100000100000v000001v001101
10000010000000000000001101
10000000000E00000010100C01
11111111111111111111111111